Test No.,Rank,P-1,C-1,M-1,Total
1,14,29,21,4,54
4,42,19,16,18,53
3,15,21,29,32,82
9,84,23,25,15,63
12,51,7,29,29,65
13,91,14,24,11,49
5,103,18,6,28,52
11,34,20,25,29,74
2,17,25,27,9,61
6,62,33,26,10,69
8,74,18,16,17,51
7,55,8,16,12,36
10,42,19,29,20,68
14,16,34,29,36,99
