Test No.,Rank,P-1,C-1,M-1,Total
1,2,28,22,18,68
4,4,29,21,36,86
3,6,32,32,24,88
9,5,39,30,32,101
12,11,17,28,36,81
13,3,32,32,29,93
5,6,33,21,36,90
11,10,24,24,36,84
2,33,29,14,11,54
6,4,39,32,36,107
8,7,21,29,21,71
7,10,16,26,18,60
10,18,32,17,29,78
14,6,40,32,36,108
