Test No.,Rank,P-1,C-1,M-1,Total
1,6,22,26,16,64
4,52,26,9,15,50
3,31,15,26,33,74
9,55,32,16,22,70
12,116,12,19,18,49
13,104,7,18,19,44
5,45,26,15,29,70
11,47,26,23,22,71
2,77,14,20,9,43
6,15,38,26,27,91
8,25,19,19,24,62
7,31,8,20,18,46
10,7,33,28,27,88
14,17,38,26,34,98
